xxxxxxxxxxxxxxxxxxxxxxxxxxxxxxxxxxxxxxxxxxxx
x     x               x                    x
x  d  x               x                    x
x                     x         h          x
x            h                             x
x                xxxxxxxxxx                x
x                                          x
x                             x            x
x      xxxxxxxxxxx            x            x
x                             x            x
x                             x            x
x              h              x            x
x                             x            x
x                                    a     x
xxxxxxxxxxxxxxxxxxxxxxxxxxxxxxxxxxxxxxxxxxxx