11
20
####################
#D#o#o-----o#-----o#
#-#-##-#--###--#-###
#----#-##-#---o#--o#
####-#--#-#-#####--#
#----#o-#-#----#---#
#-####--#-####-#-###
#------o#------#--A#
####################
####################
####################